[INFO]
18 18 180
[NOMBRE]
BURIAL CHAMBER
[MAPA]
##################
#31            13#
#      b 1       #
#  #xxxxxxxxxx#  #
#  x3        3x  #
#  x e        x  #
#  x          x  #
#  x   xxxx   x  #
# 1x   x4 x   x1 #
#  x   x  x   x  #
#  x f xxxx   x  #
# bx          x  #
#  x    c   e x  #
#  x3        3x a#
#  #xxxxxxxxxx#  #
#       ,  c     #
#31            13#
##################
[DECO]
HRUUUUURJIRUUUUURH
RAAAAAAAAAAAAAAAAR
UAAMMMMMMMMMMMAAAU
UAAaKKKKKKKKKKaAAU
UALKOOOOOOOOOOKNAU
UALKNAAAAAAAALKNAU
UALKNAAMMMMAALKNAU
RALKNALKKKKNALKNAR
IALKNALKAAKNALKNAJ
JALKNALKAAKNALKNAI
RALKNALKKKKNALKNAR
UALKNAAOOOOAALKNAU
UALKNAAAAAAAALKNAU
UALKAMMMMMMMMMKNAU
UAAaKKKKKKKKKKaAAU
UAAAOOOOOOOOOOAAAU
RAAAAAAAAAAAAAAAAR
HRUUUUURIJRUUUUURH
